ALTIMETER	AE L T IH M AH T ER
ALTITUDE	AE L T AH T UW D
BEACON	B IY K AH N
COM	K AA M
COURSE	K AO R S
DECIMAL	D EH S AH M AH L
DOWN	D AW N
EIGHT	EY T
ELEVEN	IH L EH V AH N
ELEVEN(2)	IY L EH V AH N
FIFTEEN	F IH F T IY N
FIVE	F AY V
FLAPS	F L AE P S
FLIGHT	F L AY T
FOUR	F AO R
FOURTY	F OW Y UH R T IY
GEAR	G IH R
HEADING	HH EH D IH NG
LANDING	L AE N D IH NG
LEVEL	L EH V AH L
LIGHT	L AY T
LIGHTS	L AY T S
LNAV	L N AE V
LOGO	L OW G OW
NAV	N AE V
NAVIGATION	N AE V AH G EY SH AH N
NINE	N AY N
OFF	AO F
ON	AA N
ON(2)	AO N
ONE	W AH N
ONE(2)	HH W AH N
POSITION	P AH Z IH SH AH N
SELECT	S AH L EH K T
SET	S EH T
SEVEN	S EH V AH N
SIX	S IH K S
SPEED	S P IY D
STROBE	S T R OW B
TAXI	T AE K S IY
TEN	T EH N
THIRTY	TH ER D IY
THREE	TH R IY
TWENTY	T W EH N T IY
TWO	T UW
UP	AH P
VNAV	V N AE V
WING	W IH NG
ZERO	Z IY R OW
